CCCCCCCCCCCCCCCCCCCCCCCCCCCCCCCCCCCCCCCCCCCCCCCCCCCCCCCCCCCCCCCC
L..............................RL..............................R
L..............................RL..............................R
L..............................RL..............................R
L..............................RL..............................R
L..............................RL..............................R
L..............................RL..............................R
L..............................RL..............................R
L..............................RL..............................R
L..............................................................R
L................B..............................................
L..p...........FFFFF...........................................R
L..............................RL..............................R
L..............................RL..............................R
FFFFFFFFFFFFFFFFFFFFFFFFFFFFFFFFFFFFFFFFFFFFFFFFFFFFFFFFFFFFFFFF