LCCCCCCCCCCCCCCCCCCCCCCCCCCCCCCCCCCCCCCCCCCCCCCCCCCCCCCCCCCCCCCR
L..............................LL..............................R
L..............................LL..............................R
L..............................LL..............................R
L..............................LL..............................R
L..............................LL..............................R
L..............................LL..............................R
L..............................LL..............................R
L...............p..............LL..............................R
LFFFFFFF.......................................................R
L...............................................................
L..............FFFFF...FFFFFFFFFFFFFF...........................
L.....................F..................FF....................R
L........................F.....................................R
L....................................F.........................R
L..............FF..............................................R
L..........................FF..LLFFFFFFFFFFFFFFFFFFF...........R
L.....................FF.......LL..............................R
L..............................LL...................FFFF.......R
L...............FF.............LL..............FF..............R
L..............................LL.........FF.............FF....R
L..........FF..................LL..............................R
L..............................LL......FF......................R
L................FF............LL..............................R
L..............................LL....FF........................R
L.........................FF...LL..............................R
L..............................LLFF........................F...R
L....................FF........LL...B..........................R
L..............................LLFFFFFFF.......................R
L................FF............LL.........F....................R
L..............................LL.............FF.........F.....R
LFFFFFFVVVVVVVVFFFFFVVVVVVVVFFFFFVVVVVVVVVVVVVVVVVVVVVVVVVVVVVVR