LCCCCCCCCCCCCCCCCCCCCCCCCCCCCCCCCCCCCCCCCCCCCCCCCCCCCCCCCCCCCCCR
L..............................................................R
L........................................................FFFFFFR
L.................................................F............R
L..............................................F...............R
L..............................................................R
L.........................................F....................R
L..................................F...........................R
L.............................F................................R
L.......................F......................................R
L..............................................................R
L....................F.........................................R
L..............................................................R
L..............................................................R
L.............F................................................R
L..............................................................R
L....................F.........................................R
L..........................F......F............................R
L.......................................F......................R
L..............................................................R
L..............................................F...............R
L..............................................................R
L..........................................F...................R
L..............................................................R
L....................................F.........................R
L..............................................................R
L............................F.................................R
L..................F...........................................R
L..p....F......................................................R
L....F.........................................................R
L..............................................................R
LFFFFFFVVVVVVVVFFFFFVVVVVVVVFFFFFVVVVVVVVVVVVVVVVVVVVVVVVVVVVVVR